NO       ./textures/pie.png

SO ./textures/cat.png

WE ./textures/ghost.png

EA ./textures/spider.png

F 28,28,28
C 105,105,105

111111111111111111111111
1S0000000001000000000001
101111111001011111111101
101000001000010000000101
101011101110011101110101
101010100000000001010101
100010101111111001010001
101010100000000001010101
101011101110011101110101
101000001000010000000101
101111111001011111111101
100000000000000000000001
111111111111111111111111
