NO       ./textures/waterfall.png

SO ./textures/house.png

WE ./textures/forest.png

EA ./textures/field.png

F 89,182,91
C 190,190,255

111111111111111111111111
100S00000001000000000001
101411111001011111111101
101000001000010000000101
101411101110011101110101
101010100000000001010101
100010101111111001010001
101010100000000001010101
101011101110011101110101
101000001000010000000101
101111111001011111111101
100000000000000000000001
111111111111111111111111
