NO       ./textures/sunflowers.png

SO ./textures/the_scream.png

WE ./textures/the_starry_night.png

EA ./textures/blossoms.png

F 89,182,91
C 190,190,255

111111111111111111111111
100S00000001000000000001
101211111001011112111101
101000001000010000000101
101211101110011101110101
101010100000000002010101
100010101111111001010001
101010100000000001010101
101011101110011101110101
101000001000010000000101
101121111001011111111101
100000000000000000000001
111111111111111111111111
