WE ./textures/pie.png
SO ./textures/cat.png
EA ./textures/ghost.png

NO ./textures/spider.png

F 0,0,0
C 0,0,0

11111111111
10000100011
10000100011
10000100011
10000100011
100N0100011
10000100011
10000100011
10000100011
10000100011
10000100011
10000100011
10000100011
10000100011
10000100011
10000100011
10000100011
10000100011
10000100011
10000100011
10000100011
10000100011
10000100011
10000100011
10000100011
10000100011
10000100011
10000100011
10000100011
10000100011
10000100011
10000100011
10000100011
10000100011
10000100011
10000100011
11111111111
