WE ./textures/pie.png
SO ./textures/cat.png
EA ./textures/ghost.png
NO ./textures/spider.png

F 0,0,0
C 0,0,0

111111111111
100000100011
100000100011
100000100011
100000100011
100N00100011
100000100011
100000100011
100000100011
100000100011
100000100011
100000100011
100000100011
100000100011
100000100011
100000100011
100000100011
100000100011
100000100011
100000100011
100000100011
100000100011
100000100011
100000100011
100000100011
111111111111
