WE ./textures/pie.png
SO ./textures/cat.png
EA ./textures/ghost.png
NO ./textures/spider.png

F 89,182,91
C 190,190,255

111111111111
100000100011
100000100011
100000100011
100000100011
100N00100011
100000100011
100000100011
100000100011
100000100011
100000100011
100000100011
100000100011
100000100011
100000100011
100000100011
100000100011
100000100011
100000100011
100000100011
100000100011
100000100011
100000100011
100000100011
100000100011
111111111111
