WE ./textures/pie.png
SO ./textures/cat.png
EA ./textures/ghost.png

NO ./textures/spider.png

F 0,0,0
C 0,0,0


      111111
      100001111
11111110001111
1000W0000111111
100000000111111
11111110001111111
     110111
     101111111
     111111
