WE ./textures/pie.png
SO ./textures/cat.png
EA ./textures/ghost.png

NO ./textures/spider.png

F 0,0,0
C 0,0,0


      11111111111
      10000100011
11111111010000001
10000000011111111
1000100001
1000000001
100000W001111111
1111111010000001
1000000001111111
1111111111
