WE ./path_to_the_west_texture.png
SO ./path_to_the_south_texture.png
EA ./path_to_the_east_texture.png

NO ./path_to_the_north_texture.png










F 220,100,0
C 225,30,0




















             1111111111
         1000010001
1010000001
1000000001
1000100001
1000000001
1000000001
1010000001
1000000001
1111111111
