WE ./textures/pie.png
SO ./textures/cat.png
EA ./textures/ghost.png

NO ./textures/spider.png

F 0,0,0
C 0,0,0



1111111111
1000000001
1000100001
1000100001
1000100001
1000100001
1000100001
1000100001
10N0000001
1111111111
